00000000000000111111000000
00000000000000111111000000
00111111000000000011000000
00111111110011000011000000
00000000110011000000001111
00000000110000000000001111
00444444444400111000001122
00444444444400111000001100
00000000004400110022201100
00002222224400110022201100
11001111114444440044111100
11001111114444440044111100
00000000224400000044220000
00000000224400000044000000
44444400444411110044000000
44444400444411110044000000
00000000001122220044444400
00000000001100000044444400
11111100000000000000000000
11111100000000000000000000
00001100222200000011110001
00001100000000000011110001
11000000000000000011000011
11000000000111100011000011
00000000000100100000000000
00000000000100100000000000