00000000000000000000000000
00000000110000001100000000
00111111110000001111111100
00111111110000001111111100
00110000000011000000002200
00110000000011000000002200
00110011110000001111001111
00110011000000000011001111
00110010330022003301002211
00110010332222223301002211
00110000333333333300002211
00000000333333333300000011
11000000333333333300000011
11220000333333333300001111
11220010332222223301001100
11220010330022003301001100
11110011000000000011002200
11110011110000001111002200
11220000000011000000001100
11220000000011000000001100
11111111110000001111112222
11111111110000001111112222
11110000110000001100001100
11110000000111100000001100
11110000000100100000000000
11110000000100100000000000