00000044001100001100110000
00000044001100001100110000
00000000000000001100220000
00000000000000001100220000
00000044000022001100110000
00000044001122001100110000
22001144002200001100110000
00001144002200110000110000
00001144000000110000000000
00001144000000110000000000
11001144440044444444000011
11001144440044444444000011
00000000000000330044002222
00000011000000330044000000
11110111002233333344000000
11110111002233333344001111
11000100001133333344001100
00000100001133333344001100
00000000001100330044003300
00220000001100330044003300
00110000001111110000333333
00110022000000000000333333
00110011000000000044333333
00110011000111100044333333
00000000000100100044003300
00000000000100100044003300