00000011000000000000330000
00000011000000000022330000
11000000000000330222200011
11000000000022330222200011
00000000330222200022330000
00000022330222200000330000
00000222200022330000000000
00000222200000330000000000
00000022330000000000000000
00000000330000000000000000
00000033003300330033000000
00000033223300332233000000
22110002222000022220001122
22110002222000022220001122
00000033223300332233000000
00000033003300330033000000
00000000000000000000000000
00000000220000002200000000
11000002222000022220000011
11000002222000022220000011
11000033223300332233000011
11000033003300330033000011
00000000000000000000000000
00001100000111100000110000
00001111000100100011110000
00001111000100100011110000