2111221111111111111
1101111000000013331
1000001000000003331 
1000001000000013331
1000001000000013331
1110001000000013331
1000001000000013331
1000011111101113331
1101001000000013331
1001101000000011331
1033101000000000131
1033101000000000131
1111101000000010131
2222101111111110131
2222100000000000131
2222111111111111111
2222222222222222222
2222222222222222222
2222222222222222222 

