4444444444444444444
4444444444444444444
4444444444444444444
4411111111111144444
4410000000000111444
4410000002000001444
4410030020000001444
4410300000011001444
4410000005000001444
4410000000000001444
4444100000000001444
4444100001000001444
4444111111111111444
4444444444444444444
4444444444444444444
4444444444444444444