4444444444444444444
4444444444444444444
4444444444444444444
4444444444444444444
4411111111111144444
4413300100000111444
4413300102002001444
4413300121111001444
4413300005011001444
4413300101002001444
4411111101120201444
4444102002020201444
4444100001000001444
4444111111111111444
4444444444444444444
4444444444444444444
4444444444444444444
4444444444444444444
4444444444444444444
