00000000000000000000000000
00000000000000000000000000
00000000002222000000000000
00000000002222000000000000
00000000000022000000000000
00000000000022000000000000
00222233331122113333222200
00222233331122113333222200
00000022333322333322000000
00000022333322333322000000
33000000223333332200000033
33000000223333332200000033
22330000003333330000003322
22330000003333330000003322
33000000002233220000000033
33000000220033002200000033
00000000220000002200000000
00000000220022002200000000
00000022000022000022000000
00000022000022000022000000
00000000000000000000000000
00000000000000000000000000
00000000000000000000000000
00000000000111100000000000
00002200000100100000220000
00002200000100100000220000