00000000111100000000000000
00000000111100000000000000
00000000110000002222220000
22001100110000000000220000
22001100000011000000000000
22001100000011000000000000
11001111110011110044440044
11001111110011110044440044
11000000110000000044000000
00000000000000000044000000
00000000444400444444001111
00001100444400444444001111
11110000441100111000000000
11110000441100111000000000
00000000440000000000022000
00000000440000000000022000
44444400440022001100020000
44444400440022001100020000
00000000000000000000021111
00000011110000000000021111
00000000111111111100000000
00000000110000001111000000
11111100000000000011110000
11110000000111100000110000
11000000000100100000000000
00000000000100100000000000