00000000000000222200000000
00000000000000000000000000
00002222222200000000220000
00002200000000000000220000
00002200000033002222220000
00002200000033000022220000
00220000003322000000220000
00220000003322000000220000
00000000332222000000222200
00000000332222000000002200
00220033222222002200000000
00220033222222002200000000
00020022220000002222000000
00020022220000002222000000
20000000220022222200000200
20000000220022222200000200
00022200000022223300002200
00022200000022223300002200
00220000000022330000222200
00220000000022330000222200
00222222000033000022000000
00000022000033000022000000
00000000000000000022000022
00000000000111100000002222
00000000000100100000000000
22220000000100100000000000